10
5
4 5 3 8 7 
1 8 1 2 3 
4 2 7 6 5 
6 3 1 4 3 
5 7 1 6 3 
8 2 8 1 7 
4 5 2 4 7 
2 8 6 5 6 
0 0 0 0 0 
0 0 0 0 0 
