11
5
7 1 9 2 6 
7 8 9 3 5 
8 4 3 7 2 
1 2 5 5 4 
8 6 3 7 9 
1 8 3 5 9 
1 5 9 4 7 
4 6 4 2 6 
8 3 2 1 6 
0 0 0 0 0 
0 0 0 0 0 
