8
5
3 3 3 5 6 
4 4 4 4 6 
2 2 2 2 5 
5 5 6 3 1 
1 1 1 1 4 
2 6 3 5 6 
0 0 0 0 0 
0 0 0 0 0 
